NO ./wall.xpm
SO ./wall.xpm
WE ./wall.xpm
EA ./wall.xpm
F 220,200,0
C 220,100,0
















1111111111111111111111111
1000000000110000000000101
1011000001110000000000001
100100000000000000000000111111111
111111111011000001110000000000001
100000000011000001110111111111111
11110111111111011100000010P01
11110111111111011101010111P11
11000000110101011100000P01P11
10000000000000001000000P11P1
10000000000000000000010P100P1
1100000111010101110101111N0111
11110111 1110101 101111010001
11111111 1111111 111111111111
