NO ./path_to_the_north_texture.xpm
SO ./path_to_the_south_texture.xpm
WE ./path_to_the_west_texture.xpm
EA ./path_to_the_east_texture.xpm

F 220,100,0
C 225,30,0

        1111111111111111111111111
        1000000000110000000000001
        1011000001110000000000001
        1001000000000000000000001
1111111110110000011100000000N0001
100000000011000001110111011111111
11110111111111011100000000001
11110111111111011101010000001
11000000110101011100000000001
100000000000000011000001000001
10000000000000001101010000001
110000011101010111110111000111
11110111 1110101 101111000001
11111111 1111111 111111111111



